XXXXXXXXXXXXXXXXXXXX                                                            
X       X          X                                                            
X       X          X                                                            
X       X          X                                                            
X       X          X                                                            
XXXXXXXXX          X                                                            
X                  X                                                            
X                  X                                                            
X                  X                                                            
X                  X                                                            
X                  X                                                            
XXXXXXXXXXXXXXXXXXXX                                                            
X        X         X                                                            
X        X         X                                                            
X        X         X                                                            
X        X         X                                                            
X        X         X                                                            
X        X         X                                                            
X        X         X                                                            
XXXXXXXXXXXXXXXXXXXX                                                            
12 10